no,name,kor,eng,math,total,avg,rank,c_date
1,Brady,85,67,99,251,83,0,2024-04-04
2,Albie,71,85,67,223,74,0,2024-04-09
3,Correy,97,80,70,247,82,0,2024-04-03
4,Verine,55,89,99,243,81,0,2024-04-06
5,Rahal,72,83,88,243,81,0,2024-04-09
6,Arturo,54,85,80,219,73,0,2024-04-01
7,Leesa,77,72,67,216,72,0,2024-04-02
8,Sherman,84,77,72,233,77,0,2024-04-02
9,Rance,68,94,96,258,86,0,2024-04-09
10,Bibi,95,68,84,247,82,0,2024-04-06
11,Dre,87,68,97,252,84,0,2024-04-03
12,Minnnie,91,84,100,275,91,0,2024-04-05
13,Wilden,83,89,95,267,89,0,2024-04-08
14,Geraldine,56,54,90,200,66,0,2024-04-01
15,Elvina,79,93,89,261,87,0,2024-04-06
16,Tymothy,53,72,58,183,61,0,2024-04-02
17,Jorie,69,99,66,234,78,0,2024-04-03
18,Joleen,51,81,88,220,73,0,2024-04-06
19,Hewitt,70,75,81,226,75,0,2024-04-08
20,Fernanda,90,53,83,226,75,0,2024-04-01
21,Phillida,67,69,64,200,66,0,2024-04-03
22,Urbain,67,95,67,229,76,0,2024-04-03
23,Jessie,91,98,90,279,93,0,2024-04-03
24,Ursulina,74,74,92,240,80,0,2024-04-01
25,Rodd,71,56,51,178,59,0,2024-04-02
26,Pauly,50,87,93,230,76,0,2024-04-05
27,Gian,76,79,90,245,81,0,2024-04-01
28,Neile,66,54,61,181,60,0,2024-04-05
29,Wiley,50,53,58,161,53,0,2024-04-02
30,Briana,60,73,60,193,64,0,2024-04-08
31,Penelopa,64,92,60,216,72,0,2024-04-04
32,Egor,89,71,52,212,70,0,2024-04-06
33,Alyse,63,66,52,181,60,0,2024-04-03
34,Percy,93,82,71,246,82,0,2024-04-06
35,Corrine,57,73,61,191,63,0,2024-04-01
36,Yance,92,53,66,211,70,0,2024-04-08
37,Lucita,91,74,70,235,78,0,2024-04-02
38,Hanni,55,68,94,217,72,0,2024-04-05
39,Cameron,77,89,81,247,82,0,2024-04-01
40,Mallissa,70,51,69,190,63,0,2024-04-02
41,Mildred,52,59,77,188,62,0,2024-04-02
42,Witty,52,54,72,178,59,0,2024-04-06
43,Bartholomeus,59,89,51,199,66,0,2024-04-07
44,Vera,60,63,59,182,60,0,2024-04-03
45,Lennard,90,82,74,246,82,0,2024-04-05
46,Shermie,71,93,96,260,86,0,2024-04-02
47,Tanhya,58,67,60,185,61,0,2024-04-03
48,Gillian,91,74,55,220,73,0,2024-04-07
49,Olivero,93,63,73,229,76,0,2024-04-06
50,Udale,51,94,74,219,73,0,2024-04-02
51,Adora,80,78,55,213,71,0,2024-04-05
52,Victoir,81,86,98,265,88,0,2024-04-09
53,Roana,79,100,57,236,78,0,2024-04-03
54,Reiko,84,99,59,242,80,0,2024-04-06
55,Vivianne,62,81,53,196,65,0,2024-04-03
56,Valle,65,68,50,183,61,0,2024-04-07
57,Paquito,96,93,74,263,87,0,2024-04-04
58,Freddy,52,59,66,177,59,0,2024-04-08
59,Harlie,72,74,59,205,68,0,2024-04-04
60,Roldan,70,91,67,228,76,0,2024-04-04
61,Binky,87,87,63,237,79,0,2024-04-06
62,Witty,58,60,86,204,68,0,2024-04-06
63,Edy,77,77,51,205,68,0,2024-04-04
64,Giorgia,91,56,62,209,69,0,2024-04-03
65,Boonie,74,75,58,207,69,0,2024-04-09
66,Cathi,51,94,68,213,71,0,2024-04-09
67,Camille,93,59,87,239,79,0,2024-04-09
68,Nappie,60,79,86,225,75,0,2024-04-07
69,Korey,63,51,54,168,56,0,2024-04-09
70,Worthington,82,64,55,201,67,0,2024-04-08
71,Enrique,87,63,76,226,75,0,2024-04-01
72,Anna-diana,51,92,69,212,70,0,2024-04-07
73,Brigitta,78,97,70,245,81,0,2024-04-04
74,Merralee,71,56,98,225,75,0,2024-04-02
75,Ruperta,55,75,64,194,64,0,2024-04-09
76,Nesta,75,63,66,204,68,0,2024-04-05
77,Sherrie,87,76,78,241,80,0,2024-04-05
78,Lucila,88,75,52,215,71,0,2024-04-07
79,Devonna,96,72,99,267,89,0,2024-04-02
80,Ardelle,63,98,76,237,79,0,2024-04-04
81,Nolana,99,63,82,244,81,0,2024-04-04
82,Rosa,100,68,70,238,79,0,2024-04-05
83,Manuel,81,75,72,228,76,0,2024-04-06
84,Rhianna,62,59,72,193,64,0,2024-04-04
85,Faber,66,94,84,244,81,0,2024-04-05
86,Randy,65,54,54,173,57,0,2024-04-08
87,Brittani,84,50,51,185,61,0,2024-04-06
88,Sandor,74,73,92,239,79,0,2024-04-01
89,Georgiana,67,62,74,203,67,0,2024-04-02
90,Marchall,94,78,75,247,82,0,2024-04-06
91,Alexis,50,98,72,220,73,0,2024-04-04
92,Jacynth,80,70,87,237,79,0,2024-04-08
93,Camella,84,56,87,227,75,0,2024-04-06
94,Hugibert,58,53,72,183,61,0,2024-04-07
95,Orlando,64,61,86,211,70,0,2024-04-03
96,Loydie,54,61,88,203,67,0,2024-04-08
97,Rachelle,97,79,62,238,79,0,2024-04-06
98,Novelia,91,58,90,239,79,0,2024-04-02
99,Charmaine,85,88,53,226,75,0,2024-04-04
100,Harley,57,65,62,184,61,0,2024-04-03
101,Adrea,88,98,92,278,92,0,2024-04-06
102,Ofelia,84,88,92,264,88,0,2024-04-01
103,Sharleen,73,80,79,232,77,0,2024-04-08
104,Steward,89,89,75,253,84,0,2024-04-08
105,Charin,68,91,55,214,71,0,2024-04-01
106,Lamont,77,51,66,194,64,0,2024-04-06
107,Rozina,55,75,53,183,61,0,2024-04-05
108,Alexandr,99,76,52,227,75,0,2024-04-04
109,Dede,73,94,98,265,88,0,2024-04-06
110,Berk,73,94,87,254,84,0,2024-04-07
111,Riane,78,99,95,272,90,0,2024-04-02
112,Tracee,70,81,57,208,69,0,2024-04-03
113,Devland,78,87,86,251,83,0,2024-04-07
114,Slade,57,90,80,227,75,0,2024-04-09
115,Cordell,91,73,90,254,84,0,2024-04-05
116,Stanislaw,64,83,82,229,76,0,2024-04-06
117,Philippa,73,66,54,193,64,0,2024-04-02
118,Tillie,89,70,84,243,81,0,2024-04-06
119,Carlota,71,67,77,215,71,0,2024-04-05
120,Horatius,93,85,96,274,91,0,2024-04-08
121,Tallia,75,82,80,237,79,0,2024-04-02
122,Natasha,75,79,93,247,82,0,2024-04-05
123,Reade,88,85,56,229,76,0,2024-04-04
124,Netta,79,97,65,241,80,0,2024-04-05
125,Dominique,59,54,54,167,55,0,2024-04-02
126,Aloin,78,69,79,226,75,0,2024-04-09
127,Doris,97,89,89,275,91,0,2024-04-07
128,Kennith,67,88,71,226,75,0,2024-04-02
129,Gerty,96,53,72,221,73,0,2024-04-01
130,Giorgi,94,69,79,242,80,0,2024-04-09
131,Libbey,52,99,77,228,76,0,2024-04-06
132,Bel,79,68,65,212,70,0,2024-04-03
133,Philip,91,74,77,242,80,0,2024-04-05
134,Jocelyne,70,97,94,261,87,0,2024-04-02
135,Gamaliel,54,65,63,182,60,0,2024-04-06
136,Jory,73,98,63,234,78,0,2024-04-01
137,Kirbee,50,73,100,223,74,0,2024-04-05
138,Richardo,50,68,53,171,57,0,2024-04-06
139,Gayler,100,90,86,276,92,0,2024-04-06
140,Therine,95,50,56,201,67,0,2024-04-05
141,Shelley,95,50,58,203,67,0,2024-04-03
142,Gabbie,92,72,78,242,80,0,2024-04-04
143,Madalyn,90,92,87,269,89,0,2024-04-04
144,Halsy,69,57,73,199,66,0,2024-04-07
145,Sydelle,87,64,64,215,71,0,2024-04-09
146,Ase,80,63,60,203,67,0,2024-04-07
147,Rozanne,80,88,59,227,75,0,2024-04-02
148,Cyrus,89,62,68,219,73,0,2024-04-05
149,Fitz,63,81,92,236,78,0,2024-04-07
150,Vincents,79,82,94,255,85,0,2024-04-01
151,Vivyan,99,81,71,251,83,0,2024-04-05
152,Magdalena,55,55,77,187,62,0,2024-04-02
153,Janie,58,70,77,205,68,0,2024-04-03
154,Brod,87,55,66,208,69,0,2024-04-02
155,Britni,96,84,50,230,76,0,2024-04-08
156,Deeyn,59,68,68,195,65,0,2024-04-02
157,Marjy,94,57,52,203,67,0,2024-04-03
158,Roch,68,89,97,254,84,0,2024-04-06
159,Cirillo,94,51,83,228,76,0,2024-04-05
160,Claus,52,94,60,206,68,0,2024-04-01
161,Harwell,54,98,63,215,71,0,2024-04-05
162,Kris,92,96,67,255,85,0,2024-04-01
163,Dari,92,92,74,258,86,0,2024-04-04
164,Ainslie,100,74,72,246,82,0,2024-04-04
165,Amelina,71,72,79,222,74,0,2024-04-09
166,Brewster,71,82,52,205,68,0,2024-04-02
167,Edd,98,62,89,249,83,0,2024-04-06
168,Fara,67,89,50,206,68,0,2024-04-04
169,Rorie,92,94,65,251,83,0,2024-04-08
170,Sonni,70,85,98,253,84,0,2024-04-07
171,Aryn,79,78,56,213,71,0,2024-04-06
172,Robbie,71,64,90,225,75,0,2024-04-03
173,Brien,66,99,55,220,73,0,2024-04-09
174,Kaleb,62,79,91,232,77,0,2024-04-09
175,Nancy,52,78,84,214,71,0,2024-04-07
176,Harrie,86,96,97,279,93,0,2024-04-07
177,Belita,88,88,100,276,92,0,2024-04-03
178,Hestia,52,61,54,167,55,0,2024-04-08
179,Netta,69,65,67,201,67,0,2024-04-07
180,Zebulen,68,68,57,193,64,0,2024-04-09
181,Alikee,78,76,84,238,79,0,2024-04-01
182,Vassili,75,70,93,238,79,0,2024-04-07
183,Demeter,57,77,57,191,63,0,2024-04-05
184,Marillin,90,87,57,234,78,0,2024-04-08
185,Gram,88,53,78,219,73,0,2024-04-07
186,Zebedee,55,74,87,216,72,0,2024-04-07
187,Vasilis,85,89,57,231,77,0,2024-04-06
188,Zena,96,93,65,254,84,0,2024-04-09
189,Shurwood,80,80,65,225,75,0,2024-04-03
190,Buffy,58,60,79,197,65,0,2024-04-05
191,Renaldo,81,79,52,212,70,0,2024-04-08
192,Gael,61,69,71,201,67,0,2024-04-01
193,Coop,60,77,53,190,63,0,2024-04-06
194,Odele,83,53,55,191,63,0,2024-04-03
195,Alaine,52,71,93,216,72,0,2024-04-01
196,Ari,51,66,63,180,60,0,2024-04-01
197,Whitney,94,92,76,262,87,0,2024-04-04
198,Kimmy,94,62,64,220,73,0,2024-04-06
199,Neddie,91,87,82,260,86,0,2024-04-02
200,Carroll,65,58,54,177,59,0,2024-04-09
201,Joycelin,75,83,61,219,73,0,2024-04-05
202,Allix,86,85,81,252,84,0,2024-04-06
203,Petronille,91,62,92,245,81,0,2024-04-03
204,Puff,56,86,83,225,75,0,2024-04-07
205,Tito,89,70,72,231,77,0,2024-04-07
206,Onida,85,73,98,256,85,0,2024-04-02
207,Jordana,85,91,57,233,77,0,2024-04-06
208,Laurice,71,80,98,249,83,0,2024-04-03
209,Vail,88,63,61,212,70,0,2024-04-02
210,Robbie,57,55,74,186,62,0,2024-04-03
211,Corey,77,72,89,238,79,0,2024-04-02
212,Winnie,100,69,58,227,75,0,2024-04-08
213,Lannie,72,70,86,228,76,0,2024-04-04
214,Monty,92,69,53,214,71,0,2024-04-08
215,Bree,58,62,53,173,57,0,2024-04-02
216,Arlina,91,93,68,252,84,0,2024-04-05
217,Terence,71,96,50,217,72,0,2024-04-03
218,Berne,95,61,75,231,77,0,2024-04-02
219,Andie,62,65,65,192,64,0,2024-04-01
220,Raquel,73,86,63,222,74,0,2024-04-09
221,Fairfax,88,52,57,197,65,0,2024-04-05
222,Clio,71,50,84,205,68,0,2024-04-08
223,Ramonda,81,62,71,214,71,0,2024-04-06
224,Olympia,67,84,84,235,78,0,2024-04-08
225,Aundrea,78,58,54,190,63,0,2024-04-06
226,Keelby,61,93,85,239,79,0,2024-04-07
227,Garald,88,87,95,270,90,0,2024-04-05
228,Morse,70,80,76,226,75,0,2024-04-05
229,Jobey,91,77,93,261,87,0,2024-04-04
230,Odilia,72,67,52,191,63,0,2024-04-02
231,Nannie,61,72,87,220,73,0,2024-04-05
232,Merwyn,74,69,52,195,65,0,2024-04-08
233,Ram,74,52,81,207,69,0,2024-04-03
234,Bink,56,99,61,216,72,0,2024-04-08
235,Gabbi,90,93,98,281,93,0,2024-04-08
236,Hunt,89,61,82,232,77,0,2024-04-09
237,Jacob,78,87,80,245,81,0,2024-04-06
238,Alika,76,95,95,266,88,0,2024-04-09
239,Lucian,76,82,65,223,74,0,2024-04-07
240,Ronda,88,67,54,209,69,0,2024-04-03
241,Essy,55,69,55,179,59,0,2024-04-09
242,Roosevelt,75,59,88,222,74,0,2024-04-04
243,Arda,57,88,62,207,69,0,2024-04-07
244,Nanice,59,70,83,212,70,0,2024-04-03
245,Nessy,62,76,92,230,76,0,2024-04-06
246,Damita,87,68,61,216,72,0,2024-04-04
247,Valerye,76,91,51,218,72,0,2024-04-05
248,Damian,71,95,81,247,82,0,2024-04-03
249,Mortie,89,61,96,246,82,0,2024-04-07
250,Timi,92,95,86,273,91,0,2024-04-08
251,Remington,80,50,52,182,60,0,2024-04-07
252,Benita,85,79,64,228,76,0,2024-04-07
253,Bran,59,89,74,222,74,0,2024-04-01
254,Annmarie,81,65,51,197,65,0,2024-04-01
255,Hilary,90,97,89,276,92,0,2024-04-06
256,Noby,82,92,80,254,84,0,2024-04-05
257,Archibald,94,77,73,244,81,0,2024-04-08
258,Mathilda,81,61,95,237,79,0,2024-04-04
259,Auroora,53,55,98,206,68,0,2024-04-08
260,Floria,58,73,68,199,66,0,2024-04-02
261,Jane,50,86,67,203,67,0,2024-04-05
262,Meriel,98,60,97,255,85,0,2024-04-08
263,Blanch,93,71,54,218,72,0,2024-04-09
264,Buiron,58,70,78,206,68,0,2024-04-08
265,Sharleen,60,95,80,235,78,0,2024-04-03
266,Horatia,80,83,85,248,82,0,2024-04-06
267,Gawen,75,72,79,226,75,0,2024-04-08
268,Moises,93,73,83,249,83,0,2024-04-02
269,Maitilde,90,67,55,212,70,0,2024-04-02
270,Emmy,79,76,92,247,82,0,2024-04-09
271,Thomas,91,90,66,247,82,0,2024-04-03
272,Dore,97,93,92,282,94,0,2024-04-02
273,Andree,77,95,75,247,82,0,2024-04-02
274,Jerrilyn,87,76,60,223,74,0,2024-04-01
275,Louisa,99,86,66,251,83,0,2024-04-02
276,Forest,87,81,81,249,83,0,2024-04-07
277,Bobinette,55,74,68,197,65,0,2024-04-09
278,Lindsey,95,83,75,253,84,0,2024-04-08
279,Ragnar,70,61,68,199,66,0,2024-04-02
280,Franny,99,92,97,288,96,0,2024-04-07
281,Brenn,85,68,61,214,71,0,2024-04-04
282,Brandais,80,79,81,240,80,0,2024-04-09
283,Melanie,76,66,94,236,78,0,2024-04-02
284,Lewes,62,61,76,199,66,0,2024-04-02
285,Jerrie,94,52,80,226,75,0,2024-04-01
286,Clemente,74,95,52,221,73,0,2024-04-06
287,Cathe,71,99,80,250,83,0,2024-04-09
288,Anne,79,85,70,234,78,0,2024-04-09
289,Shelley,85,74,87,246,82,0,2024-04-08
290,Sigrid,98,98,86,282,94,0,2024-04-08
291,Jannel,81,59,60,200,66,0,2024-04-04
292,Nicholas,84,59,67,210,70,0,2024-04-08
293,Nolan,52,50,62,164,54,0,2024-04-02
294,Morley,65,65,51,181,60,0,2024-04-09
295,Rowan,73,99,76,248,82,0,2024-04-01
296,Marleen,69,54,75,198,66,0,2024-04-05
297,Konstantin,82,53,99,234,78,0,2024-04-05
298,Carce,53,79,85,217,72,0,2024-04-02
299,Debby,85,98,55,238,79,0,2024-04-08
300,Babb,97,55,74,226,75,0,2024-04-02
301,Dorine,71,93,78,242,80,0,2024-04-04
302,Eula,73,94,72,239,79,0,2024-04-04
303,Randie,52,93,99,244,81,0,2024-04-06
304,Renata,94,58,87,239,79,0,2024-04-02
305,Davon,100,57,86,243,81,0,2024-04-02
306,Demeter,78,72,64,214,71,0,2024-04-07
307,Silvio,57,70,58,185,61,0,2024-04-09
308,Kassie,51,56,96,203,67,0,2024-04-07
309,Fay,79,50,83,212,70,0,2024-04-05
310,Midge,65,98,62,225,75,0,2024-04-08
311,Sky,52,81,65,198,66,0,2024-04-05
312,Merry,61,63,84,208,69,0,2024-04-02
313,Brooke,74,52,97,223,74,0,2024-04-02
314,Zaneta,97,64,64,225,75,0,2024-04-09
315,Paxon,85,81,64,230,76,0,2024-04-03
316,Zack,55,76,86,217,72,0,2024-04-08
317,Leanor,77,86,76,239,79,0,2024-04-03
318,Loni,84,94,73,251,83,0,2024-04-05
319,Carolee,84,71,52,207,69,0,2024-04-03
320,Fabian,74,88,81,243,81,0,2024-04-07
321,Leonidas,90,56,70,216,72,0,2024-04-02
322,Gard,85,73,53,211,70,0,2024-04-03
323,Dennis,67,71,60,198,66,0,2024-04-06
324,Ricca,75,85,56,216,72,0,2024-04-07
325,Nadiya,73,68,99,240,80,0,2024-04-02
326,Zorine,85,92,88,265,88,0,2024-04-05
327,Issiah,59,69,67,195,65,0,2024-04-09
328,Kathie,78,73,50,201,67,0,2024-04-03
329,Blaine,100,64,78,242,80,0,2024-04-08
330,Emmalynn,53,74,72,199,66,0,2024-04-02
331,Pincas,92,67,76,235,78,0,2024-04-09
332,Will,89,81,65,235,78,0,2024-04-04
333,Prescott,51,94,58,203,67,0,2024-04-09
334,Jilli,97,94,83,274,91,0,2024-04-02
335,Emiline,90,60,65,215,71,0,2024-04-01
336,Nikoletta,64,94,79,237,79,0,2024-04-05
337,Brucie,96,100,60,256,85,0,2024-04-01
338,De,97,95,52,244,81,0,2024-04-07
339,Sauncho,75,71,98,244,81,0,2024-04-08
340,Darnell,89,58,96,243,81,0,2024-04-09
341,Hildagarde,54,75,62,191,63,0,2024-04-07
342,Dave,83,74,50,207,69,0,2024-04-01
343,Roselia,92,68,67,227,75,0,2024-04-04
344,Bent,100,62,50,212,70,0,2024-04-06
345,Van,50,98,75,223,74,0,2024-04-06
346,Wileen,58,100,85,243,81,0,2024-04-08
347,Piotr,50,82,56,188,62,0,2024-04-03
348,Rustie,88,98,80,266,88,0,2024-04-08
349,Maurita,99,100,92,291,97,0,2024-04-03
350,Deonne,75,99,60,234,78,0,2024-04-07
351,Jermain,86,64,52,202,67,0,2024-04-01
352,Agata,66,73,76,215,71,0,2024-04-02
353,Joanie,56,53,91,200,66,0,2024-04-09
354,Tallou,63,59,87,209,69,0,2024-04-07
355,Feodora,54,66,83,203,67,0,2024-04-07
356,Clint,55,91,64,210,70,0,2024-04-01
357,Olvan,76,86,62,224,74,0,2024-04-03
358,Chariot,93,82,56,231,77,0,2024-04-08
359,Brynne,74,82,76,232,77,0,2024-04-02
360,Jordon,97,86,57,240,80,0,2024-04-04
361,Thorny,97,96,77,270,90,0,2024-04-01
362,Codi,70,71,60,201,67,0,2024-04-07
363,Ranique,50,73,100,223,74,0,2024-04-06
364,Rakel,63,80,58,201,67,0,2024-04-02
365,Darnell,88,88,81,257,85,0,2024-04-07
366,Brian,52,51,97,200,66,0,2024-04-03
367,Glendon,87,61,79,227,75,0,2024-04-02
368,Shir,74,57,79,210,70,0,2024-04-09
369,Raleigh,58,87,66,211,70,0,2024-04-03
370,Shermy,51,62,59,172,57,0,2024-04-07
371,Fielding,63,92,84,239,79,0,2024-04-01
372,Immanuel,74,60,95,229,76,0,2024-04-05
373,Cheri,86,95,91,272,90,0,2024-04-04
374,Conny,92,62,64,218,72,0,2024-04-07
375,Hollyanne,96,82,88,266,88,0,2024-04-09
376,Aurie,76,57,53,186,62,0,2024-04-05
377,Zorina,66,67,100,233,77,0,2024-04-02
378,Elisabetta,61,75,85,221,73,0,2024-04-01
379,Maryjane,66,89,90,245,81,0,2024-04-09
380,Torey,88,88,85,261,87,0,2024-04-04
381,Sandy,79,56,78,213,71,0,2024-04-08
382,Land,86,54,72,212,70,0,2024-04-06
383,Hillyer,58,84,69,211,70,0,2024-04-05
384,Cherlyn,62,69,71,202,67,0,2024-04-03
385,Rebecca,71,65,78,214,71,0,2024-04-05
386,Ailis,94,55,74,223,74,0,2024-04-06
387,Valeda,50,93,74,217,72,0,2024-04-06
388,Delmer,54,88,72,214,71,0,2024-04-02
389,Jeramie,53,78,64,195,65,0,2024-04-01
390,Glori,75,88,66,229,76,0,2024-04-04
391,Felic,94,64,65,223,74,0,2024-04-07
392,Serena,64,56,74,194,64,0,2024-04-08
393,Corbin,59,78,70,207,69,0,2024-04-09
394,Skip,83,81,71,235,78,0,2024-04-05
395,Henriette,95,86,72,253,84,0,2024-04-03
396,Debby,89,64,59,212,70,0,2024-04-02
397,Ailina,51,82,53,186,62,0,2024-04-06
398,Darice,90,55,54,199,66,0,2024-04-04
399,Blancha,76,70,56,202,67,0,2024-04-09
400,Tabatha,85,55,52,192,64,0,2024-04-01
401,Isahella,64,92,64,220,73,0,2024-04-04
402,Hortensia,76,76,99,251,83,0,2024-04-07
403,Buckie,87,95,80,262,87,0,2024-04-06
404,Chandal,67,99,51,217,72,0,2024-04-01
405,Corly,94,97,53,244,81,0,2024-04-09
406,Sly,79,76,99,254,84,0,2024-04-06
407,Shermy,96,75,64,235,78,0,2024-04-04
408,Vinita,59,76,75,210,70,0,2024-04-05
409,Ola,90,50,62,202,67,0,2024-04-08
410,Shaw,54,75,60,189,63,0,2024-04-02
411,Robinet,92,60,55,207,69,0,2024-04-07
412,Mella,58,95,76,229,76,0,2024-04-09
413,Johannes,86,88,93,267,89,0,2024-04-08
414,Taddeusz,59,86,91,236,78,0,2024-04-04
415,Elnora,54,84,85,223,74,0,2024-04-01
416,Harriette,59,70,57,186,62,0,2024-04-05
417,Hersh,73,72,75,220,73,0,2024-04-09
418,Moria,64,92,73,229,76,0,2024-04-04
419,Vina,66,77,91,234,78,0,2024-04-09
420,Merrili,76,84,59,219,73,0,2024-04-02
421,Netta,71,85,97,253,84,0,2024-04-06
422,Pier,76,92,71,239,79,0,2024-04-03
423,Angele,88,94,96,278,92,0,2024-04-06
424,Sorcha,63,61,72,196,65,0,2024-04-09
425,Adora,76,61,84,221,73,0,2024-04-06
426,Myrwyn,78,59,94,231,77,0,2024-04-08
427,Filmore,58,95,70,223,74,0,2024-04-05
428,Gae,64,71,94,229,76,0,2024-04-03
429,Gianina,71,91,91,253,84,0,2024-04-07
430,Winfred,96,98,74,268,89,0,2024-04-02
431,Barty,81,56,82,219,73,0,2024-04-09
432,Arvie,90,69,69,228,76,0,2024-04-05
433,Jenny,50,65,54,169,56,0,2024-04-01
434,Jerrie,75,71,92,238,79,0,2024-04-02
435,Reine,86,95,84,265,88,0,2024-04-06
436,Wilton,91,85,63,239,79,0,2024-04-04
437,Magdalena,56,75,59,190,63,0,2024-04-02
438,Hart,79,63,54,196,65,0,2024-04-07
439,Miguela,74,78,95,247,82,0,2024-04-07
440,Shirleen,67,66,59,192,64,0,2024-04-03
441,Sean,96,89,61,246,82,0,2024-04-02
442,Gaven,89,86,79,254,84,0,2024-04-07
443,Kip,86,79,53,218,72,0,2024-04-04
444,Judy,51,99,55,205,68,0,2024-04-07
445,Carin,89,79,51,219,73,0,2024-04-05
446,Fraze,62,92,78,232,77,0,2024-04-03
447,Elvina,65,56,68,189,63,0,2024-04-04
448,Cris,65,78,97,240,80,0,2024-04-08
449,Vin,85,68,75,228,76,0,2024-04-02
450,Sheila-kathryn,98,66,92,256,85,0,2024-04-02
451,Nisse,86,97,75,258,86,0,2024-04-03
452,Agatha,63,61,90,214,71,0,2024-04-08
453,Drusi,93,93,98,284,94,0,2024-04-06
454,Carmencita,68,77,78,223,74,0,2024-04-09
455,Theresa,94,79,63,236,78,0,2024-04-06
456,Cindra,67,75,95,237,79,0,2024-04-05
457,Gordie,67,50,76,193,64,0,2024-04-05
458,Joellyn,50,91,71,212,70,0,2024-04-04
459,Marget,65,69,84,218,72,0,2024-04-06
460,Sergeant,84,84,87,255,85,0,2024-04-02
461,Malorie,68,62,90,220,73,0,2024-04-07
462,Orrin,86,69,55,210,70,0,2024-04-05
463,Jarib,66,72,83,221,73,0,2024-04-05
464,Kyla,86,70,63,219,73,0,2024-04-04
465,Reilly,72,64,67,203,67,0,2024-04-04
466,Ivie,85,90,83,258,86,0,2024-04-07
467,Sander,82,94,64,240,80,0,2024-04-09
468,Torie,79,55,52,186,62,0,2024-04-07
469,Terrye,86,80,76,242,80,0,2024-04-06
470,Jammal,57,57,59,173,57,0,2024-04-09
471,Salome,62,75,60,197,65,0,2024-04-06
472,Galvin,80,74,57,211,70,0,2024-04-08
473,Arron,58,81,66,205,68,0,2024-04-01
474,Nils,86,95,90,271,90,0,2024-04-08
475,Lissi,74,55,94,223,74,0,2024-04-04
476,Lorena,67,73,51,191,63,0,2024-04-07
477,Bernarr,50,57,52,159,53,0,2024-04-03
478,Cynthy,59,83,62,204,68,0,2024-04-03
479,Roxy,88,53,71,212,70,0,2024-04-05
480,Zollie,60,69,61,190,63,0,2024-04-01
481,Timmie,71,95,99,265,88,0,2024-04-01
482,Corabel,86,90,73,249,83,0,2024-04-08
483,Bret,63,81,89,233,77,0,2024-04-07
484,Arabel,57,81,62,200,66,0,2024-04-07
485,Donovan,60,61,98,219,73,0,2024-04-04
486,Gothart,64,56,52,172,57,0,2024-04-06
487,Honey,78,55,95,228,76,0,2024-04-03
488,Mia,66,59,65,190,63,0,2024-04-09
489,Kristian,99,66,77,242,80,0,2024-04-06
490,Joannes,93,95,100,288,96,0,2024-04-07
491,Celinda,95,98,50,243,81,0,2024-04-08
492,Kasper,87,97,58,242,80,0,2024-04-08
493,Jill,81,67,84,232,77,0,2024-04-09
494,Marlena,60,98,95,253,84,0,2024-04-06
495,Sandor,85,66,91,242,80,0,2024-04-06
496,Audry,77,51,60,188,62,0,2024-04-06
497,Gilly,64,69,89,222,74,0,2024-04-07
498,Giovanni,64,53,62,179,59,0,2024-04-02
499,Josephina,91,74,83,248,82,0,2024-04-07
500,Catarina,98,80,55,233,77,0,2024-04-05
501,Belinda,84,84,99,267,89,0,2024-04-08
502,Lanette,57,71,72,200,66,0,2024-04-05
503,Page,70,91,85,246,82,0,2024-04-07
504,Talya,71,60,50,181,60,0,2024-04-07
505,Gard,96,93,73,262,87,0,2024-04-06
506,Nanci,77,90,95,262,87,0,2024-04-07
507,Ellery,85,59,96,240,80,0,2024-04-04
508,Alice,87,85,60,232,77,0,2024-04-01
509,Rubin,87,94,95,276,92,0,2024-04-06
510,Ardella,77,64,55,196,65,0,2024-04-09
511,Virgie,56,52,91,199,66,0,2024-04-08
512,Iormina,84,74,50,208,69,0,2024-04-05
513,Lesley,62,87,89,238,79,0,2024-04-02
514,Reta,55,95,66,216,72,0,2024-04-07
515,Christian,64,56,67,187,62,0,2024-04-06
516,Drugi,98,63,97,258,86,0,2024-04-03
517,Estelle,53,62,62,177,59,0,2024-04-08
518,Ole,60,72,74,206,68,0,2024-04-07
519,Sherwin,72,91,64,227,75,0,2024-04-03
520,Lazaro,68,58,71,197,65,0,2024-04-08
521,Winonah,53,92,59,204,68,0,2024-04-04
522,Kiel,72,68,60,200,66,0,2024-04-06
523,Arlana,93,51,77,221,73,0,2024-04-09
524,Diann,98,89,64,251,83,0,2024-04-05
525,Thaddus,92,79,86,257,85,0,2024-04-02
526,Evvie,76,85,62,223,74,0,2024-04-09
527,Lani,67,85,71,223,74,0,2024-04-01
528,Ryun,76,87,82,245,81,0,2024-04-04
529,Vivia,55,69,94,218,72,0,2024-04-02
530,Cammy,87,57,87,231,77,0,2024-04-06
531,Demetra,94,93,52,239,79,0,2024-04-09
532,Bale,72,93,95,260,86,0,2024-04-01
533,Napoleon,75,88,86,249,83,0,2024-04-01
534,Trudy,90,61,52,203,67,0,2024-04-01
535,Sigmund,72,91,93,256,85,0,2024-04-06
536,Joey,69,64,100,233,77,0,2024-04-09
537,Bink,81,94,84,259,86,0,2024-04-03
538,Antonina,76,55,58,189,63,0,2024-04-05
539,Alissa,88,69,70,227,75,0,2024-04-06
540,Sydney,57,58,64,179,59,0,2024-04-01
541,Bryn,80,94,84,258,86,0,2024-04-09
542,Nan,92,83,52,227,75,0,2024-04-02
543,Yulma,69,81,53,203,67,0,2024-04-01
544,Lion,70,99,70,239,79,0,2024-04-07
545,Beverley,97,99,89,285,95,0,2024-04-04
546,Addi,56,75,55,186,62,0,2024-04-09
547,Kin,65,94,88,247,82,0,2024-04-05
548,Dorey,88,60,52,200,66,0,2024-04-01
549,Flor,55,89,96,240,80,0,2024-04-09
550,Elsa,54,54,91,199,66,0,2024-04-07
551,Abagael,84,84,75,243,81,0,2024-04-05
552,Linc,81,59,79,219,73,0,2024-04-04
553,Gamaliel,63,52,81,196,65,0,2024-04-05
554,Vanya,63,81,80,224,74,0,2024-04-08
555,Kennith,79,61,100,240,80,0,2024-04-07
556,Ilysa,82,74,66,222,74,0,2024-04-05
557,Doretta,59,81,68,208,69,0,2024-04-01
558,Broderic,100,85,55,240,80,0,2024-04-04
559,Germaine,88,69,57,214,71,0,2024-04-02
560,Quinn,81,68,91,240,80,0,2024-04-08
561,Samara,62,53,67,182,60,0,2024-04-09
562,Wilie,79,82,97,258,86,0,2024-04-04
563,Gearalt,70,92,64,226,75,0,2024-04-08
564,Sim,56,71,100,227,75,0,2024-04-02
565,Javier,74,78,63,215,71,0,2024-04-03
566,Gino,72,77,52,201,67,0,2024-04-05
567,Luelle,60,51,51,162,54,0,2024-04-06
568,Lissie,58,77,88,223,74,0,2024-04-07
569,Kailey,66,52,96,214,71,0,2024-04-03
570,Towny,66,67,80,213,71,0,2024-04-02
571,Delphine,79,90,78,247,82,0,2024-04-05
572,Estella,95,90,79,264,88,0,2024-04-09
573,Jamie,64,82,52,198,66,0,2024-04-02
574,Claudell,74,90,56,220,73,0,2024-04-06
575,Timothee,74,84,85,243,81,0,2024-04-03
576,Samuel,58,61,72,191,63,0,2024-04-02
577,Mitchel,82,92,94,268,89,0,2024-04-09
578,Friedrich,77,51,83,211,70,0,2024-04-04
579,Roi,66,90,86,242,80,0,2024-04-02
580,Edgar,59,94,52,205,68,0,2024-04-09
581,Kaycee,55,95,77,227,75,0,2024-04-08
582,Freda,55,62,78,195,65,0,2024-04-07
583,Darrin,99,97,63,259,86,0,2024-04-08
584,Rodger,64,97,95,256,85,0,2024-04-02
585,Meagan,51,64,51,166,55,0,2024-04-05
586,Cammi,80,53,95,228,76,0,2024-04-05
587,Claribel,61,98,65,224,74,0,2024-04-04
588,Farah,90,81,59,230,76,0,2024-04-07
589,Pavlov,98,69,60,227,75,0,2024-04-07
590,Maisey,63,92,100,255,85,0,2024-04-09
591,Butch,88,60,100,248,82,0,2024-04-04
592,Alix,73,79,55,207,69,0,2024-04-07
593,Karry,67,76,81,224,74,0,2024-04-04
594,Solomon,88,77,78,243,81,0,2024-04-07
595,Davidson,50,71,100,221,73,0,2024-04-08
596,Nolly,99,96,53,248,82,0,2024-04-05
597,Mordecai,76,79,52,207,69,0,2024-04-06
598,Auroora,89,63,57,209,69,0,2024-04-02
599,Evaleen,95,64,80,239,79,0,2024-04-09
600,Felita,93,85,51,229,76,0,2024-04-01
601,Jimmy,94,53,60,207,69,0,2024-04-08
602,Artus,95,68,50,213,71,0,2024-04-09
603,Luis,89,75,78,242,80,0,2024-04-08
604,Lev,97,51,98,246,82,0,2024-04-06
605,Elmer,91,70,81,242,80,0,2024-04-09
606,Allis,53,59,59,171,57,0,2024-04-04
607,Halette,94,80,89,263,87,0,2024-04-08
608,Gray,62,90,53,205,68,0,2024-04-08
609,Eugenie,52,98,57,207,69,0,2024-04-01
610,Chelsie,65,100,92,257,85,0,2024-04-06
611,Amandi,86,66,63,215,71,0,2024-04-05
612,Imogen,73,83,90,246,82,0,2024-04-09
613,Buddie,72,84,78,234,78,0,2024-04-03
614,Melitta,74,77,71,222,74,0,2024-04-08
615,Hoyt,52,52,72,176,58,0,2024-04-05
616,Giacopo,51,74,64,189,63,0,2024-04-08
617,Cammie,71,97,75,243,81,0,2024-04-08
618,Dall,70,94,89,253,84,0,2024-04-06
619,Jerald,52,74,94,220,73,0,2024-04-03
620,Gwenneth,62,67,58,187,62,0,2024-04-06
621,Hollyanne,95,82,70,247,82,0,2024-04-07
622,Marjory,72,75,97,244,81,0,2024-04-02
623,Peder,96,72,53,221,73,0,2024-04-06
624,Coraline,65,59,83,207,69,0,2024-04-05
625,Vassily,87,66,81,234,78,0,2024-04-08
626,Stavros,75,75,93,243,81,0,2024-04-08
627,Ebba,94,99,87,280,93,0,2024-04-05
628,Tobi,95,69,85,249,83,0,2024-04-02
629,Alina,70,89,69,228,76,0,2024-04-02
630,Dore,59,80,74,213,71,0,2024-04-03
631,Juliette,62,98,95,255,85,0,2024-04-03
632,Sigismond,57,90,84,231,77,0,2024-04-03
633,Chris,68,85,75,228,76,0,2024-04-05
634,Robinette,93,80,77,250,83,0,2024-04-02
635,Aeriell,70,81,65,216,72,0,2024-04-06
636,Eryn,56,76,91,223,74,0,2024-04-05
637,Aeriel,55,99,100,254,84,0,2024-04-08
638,Viva,54,82,95,231,77,0,2024-04-02
639,Joaquin,56,64,85,205,68,0,2024-04-06
640,Jemie,74,81,67,222,74,0,2024-04-09
641,Morgan,97,87,67,251,83,0,2024-04-08
642,Darren,99,95,52,246,82,0,2024-04-08
643,Nickie,64,98,51,213,71,0,2024-04-08
644,Eada,77,64,94,235,78,0,2024-04-03
645,Josie,82,69,76,227,75,0,2024-04-04
646,Keary,94,50,90,234,78,0,2024-04-03
647,Pepillo,55,100,84,239,79,0,2024-04-08
648,Fidole,80,59,88,227,75,0,2024-04-08
649,Basia,94,98,88,280,93,0,2024-04-09
650,Sly,73,63,71,207,69,0,2024-04-01
651,Dag,84,55,64,203,67,0,2024-04-03
652,Wenona,50,64,52,166,55,0,2024-04-01
653,Titus,97,98,81,276,92,0,2024-04-07
654,Carmen,62,97,80,239,79,0,2024-04-06
655,Berkeley,91,52,97,240,80,0,2024-04-02
656,Mirella,72,64,62,198,66,0,2024-04-08
657,Dorelia,54,67,98,219,73,0,2024-04-01
658,Raynor,62,58,56,176,58,0,2024-04-02
659,Ardella,96,95,90,281,93,0,2024-04-03
660,Rollo,57,73,75,205,68,0,2024-04-06
661,Rahel,58,64,75,197,65,0,2024-04-07
662,Janey,87,74,52,213,71,0,2024-04-01
663,Sayer,78,54,81,213,71,0,2024-04-08
664,Corrie,93,68,77,238,79,0,2024-04-05
665,Antonius,70,56,69,195,65,0,2024-04-06
666,Lion,54,67,76,197,65,0,2024-04-04
667,Olly,84,64,83,231,77,0,2024-04-08
668,Dehlia,53,77,62,192,64,0,2024-04-05
669,Kaine,100,94,75,269,89,0,2024-04-09
670,Zak,99,68,66,233,77,0,2024-04-08
671,Ronni,83,97,84,264,88,0,2024-04-03
672,Amelie,69,53,100,222,74,0,2024-04-01
673,Kayle,75,85,81,241,80,0,2024-04-08
674,Louisette,79,92,86,257,85,0,2024-04-04
675,Robers,79,92,94,265,88,0,2024-04-02
676,Rois,99,95,88,282,94,0,2024-04-03
677,Annaliese,50,75,57,182,60,0,2024-04-02
678,Shir,60,96,99,255,85,0,2024-04-07
679,Margaret,100,66,71,237,79,0,2024-04-09
680,Ronda,85,94,64,243,81,0,2024-04-05
681,Saleem,73,60,87,220,73,0,2024-04-05
682,Bradney,67,53,64,184,61,0,2024-04-02
683,Murial,91,80,58,229,76,0,2024-04-03
684,Rafi,61,86,71,218,72,0,2024-04-08
685,Rae,90,69,81,240,80,0,2024-04-03
686,Gardiner,98,72,64,234,78,0,2024-04-01
687,Amii,100,59,60,219,73,0,2024-04-04
688,Walker,69,68,79,216,72,0,2024-04-08
689,Jere,79,77,89,245,81,0,2024-04-05
690,Darrick,60,70,56,186,62,0,2024-04-06
691,Dalston,53,51,61,165,55,0,2024-04-04
692,Iorgo,89,53,50,192,64,0,2024-04-06
693,Kincaid,61,55,92,208,69,0,2024-04-06
694,Herb,81,60,81,222,74,0,2024-04-04
695,Ernesto,79,77,93,249,83,0,2024-04-06
696,Cheryl,58,91,96,245,81,0,2024-04-03
697,Reinwald,74,71,97,242,80,0,2024-04-01
698,Normy,83,77,92,252,84,0,2024-04-03
699,Sorcha,56,93,86,235,78,0,2024-04-02
700,Carlita,97,97,57,251,83,0,2024-04-03
701,Itch,99,51,50,200,66,0,2024-04-04
702,Franny,86,90,81,257,85,0,2024-04-05
703,Margarette,83,67,100,250,83,0,2024-04-01
704,Harlene,56,88,94,238,79,0,2024-04-02
705,Jordain,52,100,67,219,73,0,2024-04-03
706,Colas,98,68,58,224,74,0,2024-04-07
707,Ermentrude,78,80,64,222,74,0,2024-04-05
708,Abrahan,67,71,95,233,77,0,2024-04-06
709,Jesus,97,60,70,227,75,0,2024-04-07
710,Antonina,64,52,73,189,63,0,2024-04-01
711,Jaye,58,62,64,184,61,0,2024-04-01
712,Andrea,71,53,94,218,72,0,2024-04-05
713,Inness,64,66,93,223,74,0,2024-04-01
714,Kylen,94,55,58,207,69,0,2024-04-09
715,Noni,51,66,76,193,64,0,2024-04-02
716,Mark,92,99,54,245,81,0,2024-04-09
717,Bobbee,61,96,80,237,79,0,2024-04-02
718,Allyson,66,85,92,243,81,0,2024-04-05
719,Doralyn,90,85,69,244,81,0,2024-04-02
720,Ferguson,59,92,81,232,77,0,2024-04-08
721,Olwen,76,71,86,233,77,0,2024-04-08
722,Paloma,99,88,75,262,87,0,2024-04-07
723,Saloma,69,60,71,200,66,0,2024-04-06
724,Lari,94,91,98,283,94,0,2024-04-06
725,Conni,72,83,82,237,79,0,2024-04-02
726,Sophie,98,88,57,243,81,0,2024-04-08
727,Cece,60,99,69,228,76,0,2024-04-03
728,Faythe,96,87,57,240,80,0,2024-04-02
729,Ardyth,78,67,68,213,71,0,2024-04-08
730,Olia,92,80,87,259,86,0,2024-04-09
731,Stephana,64,61,80,205,68,0,2024-04-03
732,Misha,60,97,86,243,81,0,2024-04-03
733,Rutger,93,96,61,250,83,0,2024-04-05
734,Toma,78,68,70,216,72,0,2024-04-03
735,Koren,70,99,78,247,82,0,2024-04-09
736,Hedda,96,51,91,238,79,0,2024-04-06
737,Kenton,50,77,71,198,66,0,2024-04-04
738,Perl,98,88,77,263,87,0,2024-04-04
739,Tamarra,80,68,55,203,67,0,2024-04-04
740,Alex,82,62,67,211,70,0,2024-04-03
741,Laura,52,95,62,209,69,0,2024-04-05
742,Gray,71,82,57,210,70,0,2024-04-06
743,Maxim,86,95,86,267,89,0,2024-04-03
744,Nev,58,71,76,205,68,0,2024-04-01
745,Nate,53,53,90,196,65,0,2024-04-06
746,Nona,64,59,57,180,60,0,2024-04-09
747,Ceciley,61,73,79,213,71,0,2024-04-05
748,Tansy,84,82,95,261,87,0,2024-04-05
749,Geoffry,83,89,90,262,87,0,2024-04-05
750,Nona,98,79,58,235,78,0,2024-04-07
751,Zacharia,74,88,75,237,79,0,2024-04-02
752,Henri,89,61,68,218,72,0,2024-04-08
753,Debor,84,54,52,190,63,0,2024-04-04
754,Saunders,80,89,76,245,81,0,2024-04-06
755,Ahmed,82,90,70,242,80,0,2024-04-06
756,Adrian,89,53,89,231,77,0,2024-04-02
757,Roselia,97,86,81,264,88,0,2024-04-04
758,Sutherlan,85,64,77,226,75,0,2024-04-04
759,Hunfredo,86,60,68,214,71,0,2024-04-08
760,Lyn,83,66,90,239,79,0,2024-04-04
761,Vivyan,89,67,68,224,74,0,2024-04-01
762,Marylin,94,52,51,197,65,0,2024-04-01
763,Konstance,62,98,64,224,74,0,2024-04-02
764,Siegfried,97,94,60,251,83,0,2024-04-07
765,Harriette,75,84,95,254,84,0,2024-04-05
766,Stephi,76,95,63,234,78,0,2024-04-04
767,Tim,57,56,65,178,59,0,2024-04-08
768,Wes,93,77,70,240,80,0,2024-04-03
769,Marisa,63,69,55,187,62,0,2024-04-08
770,Zorah,77,63,74,214,71,0,2024-04-08
771,Marci,83,100,92,275,91,0,2024-04-08
772,Carmelita,86,95,56,237,79,0,2024-04-06
773,Fianna,86,58,73,217,72,0,2024-04-06
774,Dare,88,56,56,200,66,0,2024-04-02
775,Vanna,73,77,82,232,77,0,2024-04-07
776,Janot,56,56,64,176,58,0,2024-04-03
777,Ardisj,86,97,89,272,90,0,2024-04-08
778,Skelly,65,57,70,192,64,0,2024-04-02
779,Arlen,98,57,82,237,79,0,2024-04-04
780,Kerr,93,72,87,252,84,0,2024-04-08
781,Othilie,62,61,80,203,67,0,2024-04-02
782,Anatol,51,58,56,165,55,0,2024-04-02
783,Roseanna,52,92,64,208,69,0,2024-04-06
784,Arlee,89,91,89,269,89,0,2024-04-07
785,Cecilia,62,53,82,197,65,0,2024-04-01
786,Ortensia,61,97,55,213,71,0,2024-04-04
787,Genia,99,85,82,266,88,0,2024-04-01
788,Sharity,80,92,73,245,81,0,2024-04-06
789,Caspar,60,76,70,206,68,0,2024-04-08
790,Addy,72,100,73,245,81,0,2024-04-08
791,Derrek,85,57,81,223,74,0,2024-04-03
792,Anselma,89,88,62,239,79,0,2024-04-05
793,Ritchie,87,97,66,250,83,0,2024-04-09
794,Seana,87,86,83,256,85,0,2024-04-04
795,Bel,54,81,51,186,62,0,2024-04-04
796,Cheston,62,72,52,186,62,0,2024-04-06
797,Morrie,95,69,95,259,86,0,2024-04-06
798,Tan,70,77,50,197,65,0,2024-04-09
799,Sidonia,57,95,93,245,81,0,2024-04-05
800,Paula,62,89,59,210,70,0,2024-04-02
801,Ingmar,68,55,64,187,62,0,2024-04-03
802,Gerrie,80,87,98,265,88,0,2024-04-03
803,Lenci,84,64,68,216,72,0,2024-04-09
804,Alaine,95,52,78,225,75,0,2024-04-06
805,Ludovika,87,71,66,224,74,0,2024-04-07
806,Cristiano,99,70,92,261,87,0,2024-04-04
807,Etheline,87,95,91,273,91,0,2024-04-08
808,Jsandye,81,94,77,252,84,0,2024-04-08
809,Fran,72,73,67,212,70,0,2024-04-02
810,Rozella,77,57,81,215,71,0,2024-04-06
811,Clara,61,97,72,230,76,0,2024-04-01
812,Ettie,88,97,64,249,83,0,2024-04-03
813,Jermain,93,91,98,282,94,0,2024-04-05
814,Robinet,90,89,82,261,87,0,2024-04-04
815,Jens,56,62,69,187,62,0,2024-04-01
816,Hedwig,63,71,68,202,67,0,2024-04-05
817,Lonnard,92,54,70,216,72,0,2024-04-07
818,Angus,52,73,79,204,68,0,2024-04-02
819,Cory,78,69,50,197,65,0,2024-04-06
820,King,82,65,89,236,78,0,2024-04-08
821,Phillip,90,66,71,227,75,0,2024-04-08
822,Terra,100,66,87,253,84,0,2024-04-09
823,Kirsten,98,81,55,234,78,0,2024-04-09
824,Channa,89,78,60,227,75,0,2024-04-09
825,Roderich,75,53,66,194,64,0,2024-04-09
826,Neal,78,79,98,255,85,0,2024-04-09
827,Myrlene,58,65,67,190,63,0,2024-04-02
828,Karrie,81,57,94,232,77,0,2024-04-04
829,Kathy,77,61,52,190,63,0,2024-04-09
830,Sisely,61,67,76,204,68,0,2024-04-04
831,Elton,72,89,82,243,81,0,2024-04-07
832,Bren,91,78,56,225,75,0,2024-04-03
833,Dewain,73,69,99,241,80,0,2024-04-09
834,Zacharia,53,86,98,237,79,0,2024-04-09
835,Hadley,76,66,52,194,64,0,2024-04-06
836,Benjy,51,99,98,248,82,0,2024-04-04
837,Emilio,81,74,66,221,73,0,2024-04-06
838,Thornton,86,86,61,233,77,0,2024-04-04
839,Schuyler,94,87,84,265,88,0,2024-04-02
840,Burtie,92,54,53,199,66,0,2024-04-09
841,Haven,52,71,60,183,61,0,2024-04-03
842,Wat,55,81,56,192,64,0,2024-04-06
843,Jessy,83,94,95,272,90,0,2024-04-06
844,Gard,54,62,81,197,65,0,2024-04-03
845,Gard,64,75,99,238,79,0,2024-04-07
846,Margarethe,74,69,72,215,71,0,2024-04-02
847,Fabian,81,84,57,222,74,0,2024-04-05
848,York,58,57,85,200,66,0,2024-04-06
849,Chloris,54,63,55,172,57,0,2024-04-07
850,Ernaline,84,96,72,252,84,0,2024-04-09
851,Bertie,77,58,100,235,78,0,2024-04-09
852,Barnard,55,69,81,205,68,0,2024-04-01
853,Nina,70,73,72,215,71,0,2024-04-06
854,Lynn,72,97,75,244,81,0,2024-04-07
855,Izabel,87,81,51,219,73,0,2024-04-05
856,Immanuel,66,85,55,206,68,0,2024-04-01
857,Arielle,91,77,64,232,77,0,2024-04-07
858,Essy,50,55,77,182,60,0,2024-04-07
859,Juieta,96,69,82,247,82,0,2024-04-04
860,Kit,52,51,56,159,53,0,2024-04-02
861,Sibley,78,63,94,235,78,0,2024-04-02
862,Madalyn,58,60,62,180,60,0,2024-04-02
863,Deanne,53,100,53,206,68,0,2024-04-02
864,Franny,69,99,73,241,80,0,2024-04-03
865,Rhetta,58,95,75,228,76,0,2024-04-06
866,Martha,54,96,63,213,71,0,2024-04-05
867,Eugenio,64,87,75,226,75,0,2024-04-02
868,Reidar,57,88,67,212,70,0,2024-04-05
869,Roch,72,89,80,241,80,0,2024-04-07
870,Coleman,89,76,92,257,85,0,2024-04-05
871,Marielle,85,56,74,215,71,0,2024-04-08
872,Flora,56,59,70,185,61,0,2024-04-04
873,Catherine,67,79,72,218,72,0,2024-04-05
874,Phaidra,69,80,79,228,76,0,2024-04-04
875,Tasia,99,68,99,266,88,0,2024-04-08
876,Gisella,60,63,81,204,68,0,2024-04-02
877,Hernando,65,58,77,200,66,0,2024-04-06
878,Cherish,96,81,53,230,76,0,2024-04-05
879,Jonell,68,69,64,201,67,0,2024-04-03
880,Isacco,67,67,83,217,72,0,2024-04-03
881,Cristine,87,66,66,219,73,0,2024-04-01
882,Christoph,91,50,82,223,74,0,2024-04-08
883,Robinetta,74,98,54,226,75,0,2024-04-02
884,Angel,81,69,51,201,67,0,2024-04-03
885,Ange,89,85,97,271,90,0,2024-04-09
886,Henrieta,77,82,65,224,74,0,2024-04-02
887,Dallis,72,67,79,218,72,0,2024-04-02
888,Danya,84,63,60,207,69,0,2024-04-07
889,Lotta,79,53,98,230,76,0,2024-04-07
890,Durante,97,58,100,255,85,0,2024-04-05
891,Paula,96,87,84,267,89,0,2024-04-01
892,Joletta,85,96,55,236,78,0,2024-04-02
893,Jessie,88,84,95,267,89,0,2024-04-06
894,Claudie,62,97,97,256,85,0,2024-04-02
895,Amble,78,56,60,194,64,0,2024-04-03
896,Whitaker,76,76,98,250,83,0,2024-04-08
897,Mano,95,96,70,261,87,0,2024-04-03
898,Giana,58,62,96,216,72,0,2024-04-04
899,Kory,82,71,91,244,81,0,2024-04-05
900,Lyndsey,57,89,83,229,76,0,2024-04-03
901,Puff,87,78,84,249,83,0,2024-04-04
902,Roxane,67,95,98,260,86,0,2024-04-05
903,Cherilyn,66,87,63,216,72,0,2024-04-05
904,Binky,93,71,55,219,73,0,2024-04-01
905,Flo,93,55,69,217,72,0,2024-04-07
906,Balduin,74,92,59,225,75,0,2024-04-09
907,Patricia,81,89,51,221,73,0,2024-04-01
908,Correy,60,61,74,195,65,0,2024-04-04
909,Maris,82,68,92,242,80,0,2024-04-06
910,Robby,56,93,93,242,80,0,2024-04-03
911,Kaia,56,53,100,209,69,0,2024-04-05
912,Silvester,60,54,78,192,64,0,2024-04-03
913,Dulcine,90,71,82,243,81,0,2024-04-08
914,Erny,53,66,55,174,58,0,2024-04-05
915,Augustine,78,68,82,228,76,0,2024-04-06
916,Rick,70,84,88,242,80,0,2024-04-03
917,Elbert,73,65,52,190,63,0,2024-04-01
918,Zorana,56,98,99,253,84,0,2024-04-08
919,Gaile,81,52,63,196,65,0,2024-04-05
920,Waylon,58,81,77,216,72,0,2024-04-07
921,Laurens,100,77,64,241,80,0,2024-04-08
922,Abigail,79,77,99,255,85,0,2024-04-04
923,Coralie,67,95,76,238,79,0,2024-04-07
924,Hallie,75,74,64,213,71,0,2024-04-05
925,Lorilee,55,90,51,196,65,0,2024-04-06
926,Frants,82,94,94,270,90,0,2024-04-08
927,Sandra,100,77,51,228,76,0,2024-04-03
928,Alysia,84,75,54,213,71,0,2024-04-01
929,Dorine,80,61,55,196,65,0,2024-04-08
930,Spenser,96,61,75,232,77,0,2024-04-06
931,Cristionna,53,90,86,229,76,0,2024-04-02
932,Maitilde,74,78,97,249,83,0,2024-04-02
933,Rudolf,90,72,66,228,76,0,2024-04-09
934,Gunar,81,92,56,229,76,0,2024-04-02
935,Merline,80,55,76,211,70,0,2024-04-03
936,Britteny,100,61,79,240,80,0,2024-04-02
937,Suzann,90,74,62,226,75,0,2024-04-01
938,Corrina,55,56,95,206,68,0,2024-04-07
939,Leonore,68,74,88,230,76,0,2024-04-06
940,Janeta,71,93,54,218,72,0,2024-04-08
941,Elysia,55,95,79,229,76,0,2024-04-03
942,Aurora,82,56,56,194,64,0,2024-04-04
943,Letisha,79,77,85,241,80,0,2024-04-06
944,Minetta,78,98,67,243,81,0,2024-04-07
945,Chalmers,59,95,97,251,83,0,2024-04-06
946,Ruben,98,95,69,262,87,0,2024-04-03
947,Ossie,66,97,100,263,87,0,2024-04-09
948,Rayner,70,92,61,223,74,0,2024-04-06
949,Robena,59,94,85,238,79,0,2024-04-02
950,Nicolette,62,85,55,202,67,0,2024-04-03
951,Jenelle,64,57,86,207,69,0,2024-04-04
952,Dudley,59,64,69,192,64,0,2024-04-08
953,Barde,98,84,67,249,83,0,2024-04-02
954,Tine,50,74,50,174,58,0,2024-04-05
955,Denny,91,81,56,228,76,0,2024-04-06
956,Zea,90,65,84,239,79,0,2024-04-01
957,Isobel,82,62,71,215,71,0,2024-04-06
958,Charleen,95,68,73,236,78,0,2024-04-02
959,Tymon,83,76,84,243,81,0,2024-04-05
960,Edgard,79,84,69,232,77,0,2024-04-01
961,Jazmin,87,53,80,220,73,0,2024-04-04
962,Maybelle,60,62,62,184,61,0,2024-04-08
963,Richie,68,89,87,244,81,0,2024-04-02
964,See,84,91,66,241,80,0,2024-04-08
965,Kimberlee,63,54,95,212,70,0,2024-04-07
966,Andra,75,63,99,237,79,0,2024-04-05
967,Fredelia,67,99,57,223,74,0,2024-04-07
968,Leonerd,83,83,67,233,77,0,2024-04-01
969,Barr,77,58,96,231,77,0,2024-04-01
970,Dalli,71,82,78,231,77,0,2024-04-07
971,Cornela,100,60,63,223,74,0,2024-04-09
972,Josepha,81,100,93,274,91,0,2024-04-08
973,Andris,97,53,89,239,79,0,2024-04-01
974,Guntar,95,77,90,262,87,0,2024-04-09
975,Valenka,67,57,80,204,68,0,2024-04-08
976,Ted,57,87,67,211,70,0,2024-04-01
977,Phebe,72,78,62,212,70,0,2024-04-06
978,Glenn,97,57,53,207,69,0,2024-04-09
979,Dev,76,62,68,206,68,0,2024-04-06
980,Kipp,93,84,82,259,86,0,2024-04-02
981,Norry,77,100,68,245,81,0,2024-04-09
982,Tanitansy,69,86,78,233,77,0,2024-04-06
983,Leoline,62,84,70,216,72,0,2024-04-02
984,Adamo,96,75,83,254,84,0,2024-04-01
985,Ilene,50,86,64,200,66,0,2024-04-06
986,Timothee,67,64,91,222,74,0,2024-04-05
987,Stanfield,95,89,97,281,93,0,2024-04-07
988,Emmalyn,100,93,93,286,95,0,2024-04-08
989,Mozelle,78,89,98,265,88,0,2024-04-04
990,Pavia,85,84,54,223,74,0,2024-04-07
991,Grata,52,67,57,176,58,0,2024-04-02
992,Miguela,79,98,94,271,90,0,2024-04-01
993,Kellina,62,84,92,238,79,0,2024-04-02
994,Vinson,97,60,57,214,71,0,2024-04-03
995,Cornela,77,87,90,254,84,0,2024-04-06
996,Hilary,51,60,68,179,59,0,2024-04-06
997,Charlotta,74,74,88,236,78,0,2024-04-05
998,Penelopa,56,89,81,226,75,0,2024-04-09
999,Shandy,78,95,89,262,87,0,2024-04-03
1000,Mureil,55,95,78,228,76,0,2024-04-07
